tilesetIso.png 7 57 114
15 15
4	4	4	4	4	4	4	4	4	4	4	4	4	4	4
4	1	1	1	1	4	4	4	4	4	4	4	4	4	4
4	4	1	1	1	1	1	4	4	1	1	1	1	6	4
4	4	1	1	1	1	1	1	1	1	1	1	1	1	4
4	4	1	1	1	1	1	1	1	1	1	1	1	1	4
4	4	1	1	1	3	3	3	3	3	3	3	2	2	4
4	4	1	1	1	3	3	3	3	3	3	3	2	2	4
4	4	1	1	1	1	1	1	1	1	1	1	1	1	4
4	4	1	1	1	1	1	1	1	4	1	1	1	1	4
4	4	1	1	1	1	1	1	1	1	1	1	1	1	4
4	1	1	1	1	1	1	4	4	1	1	1	1	1	4
4	1	1	1	1	1	1	1	4	1	1	1	1	1	4
4	4	1	1	1	1	1	1	4	1	1	1	1	1	4
4	4	1	1	1	1	1	1	4	4	4	4	4	4	4
4	4	4	4	4	4	4	4	4	4	4	4	4	4	4